##########
#........#
#..##....#
#..P..D..#
#..##....#
#......E.#
##########
